level1: {WWWWWWWWWWWWWWWWWWW
         W-------WWWWWWWWWWW
         W-------WWWWWWWWWWW
         W---------W-------W
         W-------P-W---E---W
         W---------W-------W
         W---------W-------W
         W-------WWWWWW----W
         W-------W----WWWHWW
         WW--WWWWW----W----W
         WW--W----E---W-E--W
         WW--V--------W----W
         WW--W--------W----W
         WW--WWWWWHWWWW----W
         WW--W--E----------W
         WWWWW-------------W
         WWWWWWHWWW--------W
         WW-------W--------W
         WW-------WWWWWWHWWW
         WW---E---W--------W
         WW-------W-E------W
         WWWWWWWWWW--------W
         WWWWWWWWWWWWWWWWWWW}


level2: {WWWWWWWWWWWWWWWWWWWWWWWWWWW
         WWE---W-----W-P--W------E-W
         WW----W-----W----W--------W
         WW----W-----W----W--------W
         WW----W-----W----W--------W
         WW----W-----V----V------E-W
         WW---EW-----W----W--------W
         WW----W-----W----WWWWWWWWWW
         WW----W-----W------------WW
         WWWWHWWWWHWWW-------E----WW
         W----E------W------------WW
         W-----------W----WWWWWHWWWW
         W-----------W----W----E--WW
         W-------E---W--E-W-------WW
         W-----------V----W-------WW
         W-----------W----W-------WW
         W---E-------W----W--E----WW
         W-----------WWWWWWWWWWWWWWW
         WWWWWWWWWWWWWWWWWWWWWWWWWWW}


level3: {WWWWWWWWWWWWWWWWWWWWWWWWWW
         WWWWWWWWWWW--E---WWWWWWWWW
         WWWWWWWWWWW------WWWWWWWWW
         WW-----W-PW------W---WWWWW
         WW--E--V--V------V-E-WWWWW
         WW-----W--W------W---WWWWW
         WW-----W--W---E--W---WWWWW
         WW--E--W--W------W---W---W
         WWWWWWWW--WWWWHWWWWWWW---W
         WWWW-E----W--E-------W-E-W
         WWWW------W----------W---W
         WWWWWWWWHWWWWHWWW----V---W
         W-----W---W-----W----W---W
         W-----W---W-E---W----W---W
         W--B--V-E-W-----W-E--W---W
         W-----W---W-----WWWWWWWWWW
         W-----W---W-----WWWWWWWWWW
         W--E--W---W--E--WWWWWWWWWW
         W-----WWWWWWWWWWWWWWWWWWWW
         WWWWWWWWWWWWWWWWWWWWWWWWWW}